WWWWWWWWWWWWWWWWWWWWWWWWWWWW
WhhhhhhhhhhhhWWhhhhhhhhhhhhW
WhWWWWhWWWWWhWWhWWWWWhWWWWhW
W2W00WhW000WhWWhW000WhW00W2W
WhWWWWhWWWWWhWWhWWWWWhWWWWhW
WhhhhhhhhhhhhhhhhhhhhhhhhhhW
WhWWWWhWWhWWWWWWWWhWWhWWWWhW
WhWWWWhWWhWWWWWWWWhWWhWWWWhW
WhhhhhhWWhhhhWWhhhhWWhhhhhhW
WWWWWWhWWWWW0WW0WWWWWhWWWWWW
00000WhWWWWW0WW0WWWWWhW00000
00000WhWW0000500000WWhW00000
00000WhWW0WWW00WWW0WWhW00000
WWWWWWhWW0W000000W0WWhWWWWWW
000000h000W060070W000h000000
WWWWWWhWW0W000000W0WWhWWWWWW
00000WhWW0WWWWWWWW0WWhW00000
00000WhWW0000000000WWhW00000
00000WhWW0WWWWWWWW0WWhW00000
WWWWWWhWW0WWWWWWWW0WWhWWWWWW
WhhhhhhhhhhhhWWhhhhhhhhhhhhW
WhWWWWhWWWWWhWWhWWWWWhWWWWhW
WhWWWWhWWWWWhWWhWWWWWhWWWWhW
W2hhWWhhhhhhhP0hhhhhhhWWhh2W
WWWhWWhWWhWWWWWWWWhWWhWWhWWW
WWWhWWhWWhWWWWWWWWhWWhWWhWWW
WhhhhhhWWhhhhWWhhhhWWhhhhhhW
WhWWWWWWWWWWhWWhWWWWWWWWWWhW
WhWWWWWWWWWWhWWhWWWWWWWWWWhW
WhhhhhhhhhhhhhhhhhhhhhhhhhhW
WWWWWWWWWWWWWWWWWWWWWWWWWWWW